111111111111111111111111111111111111111111111111
100000000002000000000000000000000000200000000001
100000000002000000000000000000000000200000000001
100000000022200000000000000000000002220000000001
100000002220222000000000000000000222022200000001
100000000022200000000000000000000002220000000001
100000000002000000000000000000000000200000000001
100000000002000000000000000000000000200000000001
100000000000000000000000000000000000000000000001
100000000000000000000000000000000000000000000001
100000000000000000000000000000000000000000000001
100000000000000000002000000000000000000000000001
100000000000000000002000000000000000000000000001
111111111111111111111000000000000000000000000021
100000000000000000002000000000000000000000000221
100000000000000000002000000000000000000002222221
100000000000000000002000000000000000000000000221
100000000000000000002000000000000000000000000021
100000000000000000002222222222220000000000000001
100000000000000000000000200000000000000000000001
100000000000000000000000200000000000000000000001
100000000000000000000000200000000000000000000001
100000000000000000000000200000000000000000000001
100000000000000000000000200000000000000000000001
100000000000000000000000200000000000000000000001
100000000000000022222222222200000000000000000001
120000000000000000000000000200000000000000000001
122000000000000000000000000200000000000000000001
122222200000000000000000000200000000000000000001
122000000000000000000000000200000000000000000001
120000000000000000000000000111111111111111111111
100000000000000000000000000000000000000000000001
100000000000000000000000000000000000000000000001
100000000000000000000000000000000000000000000001
100000000000000000000000000000000000000000000001
100000000000000000000000000000000000000000000001
100000000002000000000000000000000000200000000001
100000000002000000000000000000000000200000000001
100000000022200000000000000000000002220000000001
100000002220222000000000000000000222022200000001
100000000022200000000000000000000002220000000001
100000000002000000000000000000000000200000000001
100000000002000000000000000000000000200000000001
111111111111111111111111111111111111111111111111