1111111111111111111111111111111111111111
1             2                        1
1             2  3                     1
1             2                        1
1             211111                   1
1        1                             1
1        1                             1
1        1                             1
1        2         21                  1
1        2         22                  1
1        2         22                  1
1                  22                  1
1                  22                  1
1     22221111     22                  1
1                  12     222111       1
1                  12                  1
1                  12                  1
1                  12                  1
1              222212                  1
11111111       222222        11111111111
1            22      22                1
1            22      22                1
1              222222                  1
1              212222                  1
1              21                      1
1              21                      1
1              21                      1
1              22                      1
1              22                      1
1              22                      1
1              22         2            1
1                         1            1
1                         2            1
1                         1            1
1                         1            1
1               111111    1            1
1               2                      1
1               2   4                  1
1               2                      1
1111111111111111111111111111111111111111